TableName                | EntryIndex   | EntryName
Map                      | 0            | OB      
Map                      | 1            | T8      
Map                      | 2            | TA      
Map                      | 3            | TB      
Map                      | 4            | ThreeDNow
Map                      | 5            | XOP8    
Map                      | 6            | XOP9    
Map                      | 7            | XOPA    
